##A###############
#......#....#....#
#......#....#....#
#......#....#....#
#......#....#....#
#......#+####+####
#......+........v#
##################
-
# Wall
. Floor
+ Door
A Door -> Island -> A
v Floor, Ladder Down -> AbandonedHouse-Basement -> ^