...............//#.....
.///////.....////#.....
/////////////////#.....
//####///////////##....
//#::#///////////#.....
//#::#//////////##.....
/##::##/////#####......
/#::::#/////#::b.......
/#::::#/////#::#.......
/#::###///&&#::#.......
/##:::#&&&&&#::########
//#:::#######:::::::::#
&&#:::::::::=:::::::::#
.&##d###############::#
...###.............####
-
# Wall
& Tree
. 
/ Water
: Floor
b Path Door, JewelSlot:CastleThroneRoomLeft
d Path Door, Wood Door:CastleParapetBottomLeft
= Door