..........####h#
.##########::::#
.#:::::::::::::#
.#:::#:::::::::#
##:::#::######:#
#::::#:::::::::#
#::::#:::::#:::#
#::R:#:::::#:::#
#::::::::::#:{:#
################
-
# Wall
. 
: Floor
R Floor, Dagger
h Path Door, Wood Door:CastleBasementRight
{ Floor, Rat
