.........###m#.
.........#:::##
........##::::#
.......##::*::#
.....###:::::##
....##:::#####.
...##::::##....
..##::::::##...
.##::::::::##..
##::::::::::##.
#::::::::::::#.
#::::::::::::#.
#::::::::::::#.
p::::::::::::#.
########k#####.
-
# Wall
* Floor, Red Gem
. 
: Floor
k Path Door:CavesMainBTop
m Path Door:CavesFalseExitTop
p Path Door:CavesLinkTallRight
