.........######
.........#::3:i
........##::::#
.......##:{:::#
......##:::::##
....###::#####.
...##::::##....
..##::::::##...
.##::::::::##..
##::::::::::##.
#::::::::::::#.
#::::::::::::#.
#::::::::::::#.
#::::::::::::#.
########j#####.
-
# Wall
. 
: Floor
i PathDoor, Red Door:CavesToCastle
j Path Door:CavesMainATop
{ Floor, Rat
3 Grass, Kim the Rat