.........##.........
####################
#::#`:#:####:#::#::#
#::#::#::##::#::#::#
#::#::#::::::#::#::#
##=##=##::::##=##=##
#::::::::::::::::::#
#::::::::::::::::::#
##=###=##::##=###=##
#:::#:::#::#:::#:::#
#:::#:::#::#:::#:::#
#:T:#!::#::#:S:#:`:#
##########I#########
-
! Floor, Gold Key
# Wall
. 
: Floor
I Path Door, Wood Door:DeadEndAlleywaysLodgings
` Floor, Sword
= Door
S Floor, Club
T Floor, Mace