////////////////
///&&&/.....////
//..&&....&..///
///..../..&.////
/////////...////
//...///.....///
//..&.........//
/p.......&&&.///
//.#A###..&&&.//
/..#####.....///
/..#####&./&////
//...&&&&.//////
///.&&&&..//////
///..&&..///////
//...../////////
////////////////
-
# Wall
/ Water
. Floor
A Door -> Map2 -> A
& Floor, Trees
p Floor, Player