############
#..........#
#.p........#
#..........#
########...#
       #...#
       #...#
       ##A##
-
# Wall
. Floor
A Door -> Map2 -> A
* Floor, Gold
p Floor, Player
g Floor, Bob the Goblin