////////////////////////////////
///&&&/p,,,,////////////////////
//,,&&,,,,&,,///////////////////
///,,,,/,,&,////////##,,,,,##///
/////////,.,/////&&&#########///
//,,,///,,.,,///&&,,,#######,,//
//,,&,,....,,,,,,,,,&#######,,//
/,,,....,&&&,///,,,,,B######,,//
//,#A###,,&&&,//,,,,&#######,,//
/,,#####,,,,,///,&,,,#######,,//
/,,#####&,/&/////&,,#########///
//,,,&&&&,////////,,##,,,,,##///
///,&&&&,,//////////////////////
///,,&&,,///////////////////////
//,,,,,/////////////////////////
////////////////////////////////
-
# Wall
/ Water
. Path
, Grass
A Door -> Map2 -> A
B Door -> Map3 -> A
& Grass, Trees
p Grass, Player