////////////////
///&&&/p,,,,////
//,,&&,,,,&,,///
///,,,,/,,&,////
/////////,.,////
//,,,///,,.,,///
//,,&,,....,,,//
/,,,....,&&&,///
//,#A###,,&&&,//
/,,#####,,,,,///
/,,#####&,/&////
//,,,&&&&,//////
///,&&&&,,//////
///,,&&,,///////
//,,,,,/////////
////////////////
-
# Wall
/ Water
. Floor
, Grass
A Door -> Map2 -> A
& Floor, Trees
p Grass, Player