##A##############
#......#...#....#
#......#...#....#
#..g...#...#....#
#......#...#....#
#......#+###....#
#......+...+....#
#################
-
# Wall
. Floor
+ Door
A Door -> Map1 -> A
g Floor, Bob the Goblin