##A##############
#......#...#....#
#......#...#....#
#..g...#...#....#     ####
#......#...#....#     #..C
#......#+###....B     #..#
#......+...+....#     #..#
##########################
-
# Wall
. Floor
+ Door
A Door -> Map1 -> A
B Door -> Map2 -> C
C Door -> Map1 -> A
g Floor, Bob the Goblin