    #####A##
    #......#
    #.....*#   ######
    #......#   #*..*#
    #.....*#   #....#
    #......#####....#
    #*.*.*........g.#
    #################
-
# Wall
. Floor
A Door -> Map1 -> A
* Floor, Gold
p Floor, Player
g Floor, Bob the Goblin