##A##############
#......#*.*#*..*#
#.....*#...#....#
#..r...#*.*#*..*#
#.....*#...#....#
#......#+###....#
#*.*.*.+...+..g.#
#################
-
# Wall
. Floor
+ Door
A Door -> Map1 -> A
* Floor, Gold
g Floor, Bob the Goblin
r Floor, Tim the Rat