..........####h#
.##########::::#
.#:{:::::::::::#
.#:::#:::::::::#
##:::#::######:#
#::::#:::::::::#
#::::#:::::#:::#
#::`:#:::::#:::#
#::::::::::#:{:#
################
-
# Wall
. 
: Floor
` Floor, Sword
h Door:CastleBasementRight
{ Floor, Tim the Rat
