..////.....////..
./####/////####/.
./#::#######::#/.
./#::::###::::#/.
./##::::#::::##/.
//#::::-|-::::#//
/##:::::-:::::##/
##:::::::::::::##
b:::::::::::::::c
#::###:::::###::#
#::::#&:::&#::::#
########:########
.......#:#.......
.......#:#.......
.......#:#.......
.......#a#.......
-
# Wall
& Tree
- JewelSlot
. 
/ Water
: Floor
a Door:CastleThroneRoomMain
b Door:CastleThroneRoomLeft
c Door:CastleThroneRoomRight
| PathDoor:YouWin