...............//#.....
.///////.....////#.....
/////////////////#.....
//####///////////##....
//#::#///////////#.....
//#::#//////////##.....
/##::##/////#####......
/#::::#/////#::b.......
/#::::#/////#::#.......
/#::###///&&#::#.......
/##:::#&&&&&#::########
//#:::#######:::::::::#
&&#::::::::::::::::::#
.&##d###############::#
...###.............####
-
# Wall
& Tree
. 
/ Water
: Floor
b Door:CastleThroneRoomLeft
d Door:CastleParapetBottomLeft