.........######
.........#::::i
........##::::#
.......##:{:::#
......##:::::##
....###::#####.
...##::::##....
..##::::}:##...
.##::}:::::##..
##::::::::::##.
#:::::::::}::#.
#::::::}:::::#.
#::}:::::::::#.
#::::::::::::#.
########j#####.
-
# Wall
. 
: Floor
i PathDoor, Red Door:CavesToCastle
j Path Door:CavesMainATop
{ Floor, Tim the Rat
} Floor, Goblin Horde
