.........##.........
####################
#::#`:#:####:#::#::#
#::#::#::##::#::#::#
#::#::#::::::#::#::#
######::::######
#::::::::::::::::::#
#::::::::::::::::::#
#######::#######
#:::#:::#::#:::#:::#
#:::#:::#::#:::#:::#
#:::#!::#::#:::#:`:#
##########I#########
-
! Floor, Gold Key
# Wall
. 
: Floor
I Door:DeadEndAlleywaysLodgings
` Floor, Sword
 undefined
