########
#,,,,,,#
#,,,,,,#
#,,,,,,#
#,,,,,,#
#,,,,,,#
#,,,,,,#
#=######
#,,,,,,#
#,,,,,,#
#,,,,,,O
#,,,,,,#
#,,,,,,#
#,,,,,,#
#,,,,,,#
########
-
# Wall
, Path
O Door:LittleVillageEastHouse
= Door
