########
#,,,,,,#
#,,,,,,#
#,,,,,,#
#,,,,,,#
M,,,,,,#
#,,,,,,#
#,,,,,,#
#,,,,,,#
#######
#,,,,,,#
#,,,,,,#
#,,,,,,#
#,,,,,,#
#,,,,,,#
########
-
# Wall
, Path
M Door:LittleVillageWestHouse
 undefined
