###t##########u###
#,,,,,,,,,,,,,,,,#
#,,,,,,,,,,,,,,,,#
#,##,,,####,,,##,#
#,##############,#
#,#::::::::::::#,#
#,#::::::::::::#,#
#,#:##::::::##:#,#
#,###::::::###,#
#,,,#::::::::#,,,#
#,,,#::::::::#,,,#
#,,,#:!::::::#,,,#
#,,,####::####,,,#
#,,,#,,####,,#,,,#
#,,,,,,,##,,,,,,,#
v,,,,,,,,,,,,,,,,#
#,,,,,,,,,,,,,,,,#
##################
-
! Floor, Gold Key
# Wall
, Path
: Floor
t Door:VeniceTavernTopLeft
u Door:VeniceTavernTopRight
v Path Door, Red Door:VeniceTavernBottom
 undefined
