############
#..........#
#.p........#
#..........#
########...#
    #..+...#
    #..#...#
    #####+##
    #......#
    #.....*#   ######
    #......#   #*..*#
    #.....*#   #....#
    #......#####....#
    #*.*.*.+.g.+....#
    #################
-
# Wall
. Floor
+ Door
* Floor, Gold
p Floor, Player
g Floor, Bob the Goblin